Recondite -  Difficult to penitrate (difficult to understand).

Gall -  Trait of being rude and impertinent.

Frivolous - Not serious.

Didactic - Instructive (useful and informative).

Gainsay - Deny or oppose.

Aesthetic - Concerned with beauty/artistic movement.

Rustic - Characteristics of Rural life.

Bucolic - Plesent aspect of a country.

Banal - Repeated too often.

Reticent - Not revealing one's thoughts (no talk policy).

Diffident - lack of self-confidence.

Lambast - Criticize severly.

Chortle - To chuckle or laugh.

Preclude - Keep from arising or happening.

Fortuitous - Occuring by happy chance.

Torpor - Lack of lethargy/Energy/Enthusiasm.

Volubility - Talking or writing easily.

Gossamer - Unusual lightness or delicacy (delicate).

Platitude - Obvious remark.

Querulous - Habitually complaining.

Apathetic - Lack of interest.

Impudent - Improperly bold and forward.

Vociferous - Offensively loud.

Dogmatic - Highly opioniated.

Culminate - Reach the hughest point.

Perfidy - Deliberate betrayal.

Conspicous - Completely obvious.

Mitigate - Make less severe or harsh.

Audacious - Willing to be bold in public.

Eschew - Avoid, to stay clear of.

Mawkish - Overly sentimental to the point that is disgusting.